NO ./tools/assets/Wall-007.xpm
SO ./tools/assets/Wall-008.xpm
EA ./tools/assets/Wall-009.xpm
WE ./tools/assets/Wall-010.xpm

F 255,0,255
C 0,218,218


1111111111111111111111111111111111111111111
1000000000000000000000000000000001000001001
10000000000000000000000000000000000010000W1
1000111111111111111111111111111111111111111
1000100000000001000000000111111111110000111
1000100000000001000000000111111111110000111
1000100000000001000000000000001111110000111
1000100000000001000000000000000001110000111
1000100000000001000000000000000000000000111
1000100000000000000000000000000000000000111
1000111111111111111111111111111111110000111
1000111111111111111111111111111111110000111
1000000000000000000000000000000000000000111
1000000000000000000000000000000000000000111
1111111111111111111111111111111111111111111
